^########################^
#........................#
#........................#
#...........#...^....^...#
^#######..##^####....####^
#...........#...^....^...$
#....^......#............$
#....#######^............$
#...........#............$
#......^....#............$
^#######....#............$
#..|........#............$
#...........#............$
#...........#......@.....$
^########################^