^########################^
#......................|.#
#..#..#..................#
#..#$$#........####......#
#..#$$#........#$$#......#
#..####........#$$#......#
#..............####......#
#........................#
#.###...###..............#
#.#$#...#$#...########...#
#.###...###...#$$$$$$#...#
#.............#$$$$$$#...#
#.............#$$$$$$#...#
#.@...........#$$$$$$#...#
^########################^