^########################^
#........................#
#.....................#..#
#.........###.........#..#
#.....................#..#
#...###.........###...#..#
#.....................#..#
#....|....###.........#..#
#.....................#..#
#...###.........###...#..#
#.....................#..#
#.........###.........#..#
#.....................#..#
#.....................#.@$
^#####################^##^