^########################^
#........................#
#.#........^..........#..#
#.#.......###.........#..#
#.#..^.....^.....^....#..#
#.#.###.........###...#..#
#.#..^.....^.....^....#..#
#.#..|....###.........#..#
#.#........^.....^....#..#
#.#.###.........###...#..#
#.#..^.....^.....^....#..#
#.#.......###.........#..#
#.#........^..........#..#
#.......................@$
^#####################^##^
