##########################
#............#...#^^^#...#
#....|.......#...#...#...#
#............#...........#
#..................^.....#
#..................#.....#
#............^.....#.....#
#............#...........#
#............#...........$
#............#...........#
#............#.....^.....#
#.....#####..#.....#.....$
#.........#........#.....$
#..@......#........#.....$
##########################
