##########################
#............#...#^^^#...#
#....|.......#...#...#...#
#............#...........#
#............#...........#
#............#.....#.....#
#............#.....#.....#
#............#.....#.....#
#............#.....#.....#
#............#.....#.....#
#............#.....#.....#
#.....#####..#.....#....^#
#.........#........#.....#
#..@......#.......^#^....$
##########################