##########################
#........................#
#..#..................#..#
#..#..##############..#..#
#..#..................#..#
#..#..#............#..#..#
#..#..#..#....|.#..#..#..#
#.....#..#......#..#.....#
#..#..#..#.@....#..#..#..#
#..#..#...######...#..#..#
#..#..................#..#
#..#..................#..#
#...##################...#
#........................#
$$$$$$$$$$$$$$$$$$$$$$$$$$