^##################^^####^
#..........#$$#....##....#
#.......|..#$$#....$$....#
#..........#$$#..........#
#..........#$$#..........#
#..........#$$#..........#
#..........#$$#..........#
#..........#$$#..........#
#..........#$$#.@........#
#......^^#^^##^##^^......#
#......##^######^##......#
#...^................^...#
#...#................#...#
#...#................#...#
^###^################^###^
