##########################
#........................#
#....|...................#
#........................#
#........................#
#........................#
#........................#
#........................#
#.............##.........#
#........................#
#........................$
#........................$
#........................$
#..@.......^.............$
##########################