##########################
#........................#
#........................#
#........................#
#........................#
#........................#
#........................#
#........................#
#........................#
#.|......................#
#...........^............#
#........................$
#........................$
#.@......................$
##########################