^####^#####^#####^#######^
#....#.....#.....#.......#
#....#.....#.....^#####^.#
#....^.....^...........#.#
$...................|..#.#
$.......^..............#.#
$.......#..............#.#
$.......#..............#.#
$.......#..............#.#
$.......#..............#.#
$.......#..............#.#
#....^..#..^...........#.#
#....#..#..#.....^#####^.#
#.@..#..#..#.....#.......#
^####^##^##^#####^#######^