^########################^
#........................#
#.^####################^.#
#.#....................#.#
#.#.^################^.#.#
#.#.#................#.#.#
#.#.#.|..............#.#.#
#.#.#................#.#.#
#.#.^###############.#.#.#
#.#..................#.#.#
#.^##################^.#.#
#......................#.#
^######################^.#
$.@......................#
^########################^