##########################
#.........^.......^......#
#........................#
#........................#
#........................#
#.@........^.....^.......#
############.....#########
#........................#
#........................#
#.|......................#
#####......###############
#........................$
#........................$
#........................$
##########################