^######^#################^
#^....^#$$$$$$$$$$$$$$$$$#
#^..^.^#$$^##^$$$$$$$$$$$#
#^..^.^#$$#..#$$$$^##..###
#^..^.^^##^..#$$$$#......#
#^..^.^#.|...#$$$$#......#
#^#.^.^#.....^####^......#
#^#...^#.................#
#^#...^#.........^#######^
#^....^#.........#$$$$$$$#
#^....^#.......##$$$$$$$$#
#^.^..^#.....##$$$$$$$$$$#
#..^..^#...##$$$$$$$$$$$$#
#@.^.....##$$$$$$$$$$$$$$#
^########^^##############^